NO ./imgs/north.xpm
SO ./imgs/south.xpm
WE ./imgs/west.xpm
EA ./imgs/east.xpm


F 220,100,0
C 225,30,255





1111111111111111111111111111111111111111111
1000000000000000000000000000000000000000001
1111110000000000000000011110000000000000001
1000000000000000000000000000000000000000001
1000000000000000000000000000000000000N00001
1000000000000000000000000000000000000000001
1111111111111111111111111111111111111111111






